HHHHHHHHHHHHHHHHH
H*   HH        *H
H HH     H HHHH H
H    HHH H    H H
HHH HH     HH   H
H      HoH    H H
H HHHH HHH HH H H
H       H     HHH
H HH HH   HHH H H
H HH HHH HHHH H H
H*      <      *H
HHHHHHHHHHHHHHHHH