HHHHHHHHHHHHHHH
H*      H    *H
H HH HH HHHHH H
H     HHH   H H
H H H H   HHH H
H H H HoH     H
H   HHHHH HHH H
H H H     H   H
H H HHH HHHHH H
H*H    <     *H
HHHHHHHHHHHHHHH