HHHHHHHHHHHHHHHHHHHHHHHHHHHHHH
H.*........................*.H
H.HHHH.HHHHHHHHHHHHHHHH.HHHH.H
H.HHHH.HHHHHHHHHHHHHHHH.HHHH.H
H............................H
H.HHHH.HHH----------HHH.HHHH.H
H.HHHH.HHH----o-----HHH.HHHH.H
H.HHHH.HHH----------HHH.HHHH.H
H......HHH----------HHH......H
H.HHHH.HHHHHHHHHHHHHHHH.HHHH.H
H.HHHH.HHHHHHHHHHHHHHHH.HHHH.H
H.............<..............H
H.*........................*.H
HHHHHHHHHHHHHHHHHHHHHHHHHHHHHH