HHHHHHHHHHHHHHHHHHHHHHHHHHHHHHHH
H.*............HH............*.H
H.HHHHHHHH.HHH.HH.HHH.HHHHHHHH.H
H.HHHHHHHH.HHH.HH.HHH.HHHHHHHH.H
H..............................H
H.HHHH.HH.HHHHH--HHHHH.HH.HHHH.H
H.HHHH.HH.H---o------H.HH.HHHH.H
H.HHHH.HH.HHHHHHHHHHHH.HH.HHHH.H
H......HH.......<......HH......H
HHHHHH.HH.HHHHHHHHHHHH.HH.HHHHHH
H..............................H
H.HHHHHHHHHHHH.HH.HHHHHHHHHHHH.H
H.*............HH............*.H
HHHHHHHHHHHHHHHHHHHHHHHHHHHHHHHH